2024-01-03
2024-01-04
2024-01-06
2024-01-09
2024-01-13
2024-01-18
2024-01-24
2024-01-31
2024-02-08
2024-02-17
2024-02-27
2024-03-09
2024-03-21
2024-04-03
2024-04-17
2024-05-02
2024-05-18
2024-06-04
2024-06-22
2024-07-11
2024-07-31
2024-08-21
2025-01-03
2025-01-04
2025-01-06
2025-01-09
2025-01-13
2025-01-18
2025-01-24
2025-01-31
2025-02-08
2025-02-17
2025-02-27
2025-03-10
2025-03-22
2025-04-04
2025-04-18
2025-05-03
2025-05-19
2025-06-05
2025-06-23
2025-07-12
2025-08-01
2025-08-22
