2025-01-03
2025-01-04
2025-01-06
2025-01-09
2025-01-13
2025-01-18
2025-01-24
2025-01-31
2025-02-08
2025-02-17
2025-02-27
2025-03-10
2025-03-22
2025-04-04
2025-04-18
2025-05-03
2025-05-19
2025-06-05
2025-06-23
2025-07-12
2025-08-01
2025-08-22
2030-01-03
2030-01-04
2030-01-06
2030-01-09
2030-01-13
2030-01-18
2030-01-24
2030-01-31
2030-02-08
2030-02-17
2030-02-27
2030-03-10
2030-03-22
2030-04-04
2030-04-18
2030-05-03
2030-05-19
2030-06-05
2030-06-23
2030-07-12
2030-08-01
2030-08-22
